NO /home/yiken/mywork/cub3d/wall_textures/wall_north.png
WE /home/yiken/mywork/cub3d/wall_textures/wall_west.png
SO /home/yiken/mywork/cub3d/wall_textures/wall_south.png
EA /home/yiken/mywork/cub3d/wall_textures/wall_east.png
C 125, 109, 255
F 34, 192, 0212

 111111111
10000000001
10000000001
10000000001
10000000001
10000N00001
10000000001
10000000001
10000000001
10000000001
 111111111