     
   
   F       1         ,     3    ,    9    
  
  
       NO         textures/wall_north.png      



    

SO           textures/wall_south.png

WE    textures/wall_west.png
EA textures/wall_east.png


C       255, 0    , 0      








111111111111111111111111111
111111111010100000100111111
101100101000001000111111111
100100110111110111111111111
10011110S000100100111111111
100000000000000100111111111
100111111111100100111111111
101100000000000101111111111
100000000100011111111111111
111111111111111111111111111















