     
   
   F       1         ,     3    ,    254    
  
  
       NO         textures/wall_north.png    



    

SO           textures/wall_south.png

WE    textures/wall_west.png
EA textures/wall_east.png


C       255, 0    , 0      








        1111111111111111111
1111111111101000001001111
10110000010000010011111
1001001001111101111
10011110W0001001001
1000000000000001001
1001111111111001001
1111000000000001011
1000000001000111101
11111111111111  1111















