     
   
   F       1         ,     3    ,    9    
  
  
       NO         assets/wall_north.png      



    

SO           assets/wall_south.png

WE    assets/wall_west.png
EA assets/wall_east.png


C       255, 0    , 0   


1111111111111111111111111
1000000000110000000000111
101100000111000000000011
100100000000N000000000111
1111111110110000011100111
1000000000110000011101001
1111011111111101110000111
1111011111111101110101111
11110111 1110001 10111111
11111111 1111111 11111111
11111111 1111111 11111111
11111111 1111111 11111111
11111111 1111111 11111111


