

    111111111111
1111111000001
1011110N0001111111
10111111111
1111 1111 11