C 179, 255, 255

NO wall_textures/wall_north.png
F 0, 179, 0
WE               wall_textures/wall_west.png        




SO wall_textures/wall_south.png
EA wall_textures/wall_east.png




        1111111111111111111111111
        1000000000110000000000001
        1011000001110000000000001
        1001000000000000000000001
111111111011000001110000000000001
100000000011000001110111111111111
111111111111111111111111111111111
111111111111111111111111111111111
11000001110101011111011110N0111
11110111 1110101 101111010001
11111111 1111111 111111111111